Species	Status
Acrochordus_dehmi	extinct
Adinophis_fisaka	extinct
Afrotortrix_draaensis	extinct
Agkistrodon_piscivorous	extant
Alamitophis_argentinus	extinct
Alamitophis_elongatus	extinct
Alamitophis_tingamarra	extinct
Albaneryx_depereti	extinct
Albaneryx_volynicus	extinct
Alsophis_cantherigerus	extant
Amananulam_sanogoi	extinct
Amaru_scagliai	extinct
Ameiseophis_robinsoni	extinct
Anilioides_minuatus	extinct
Anilioides_nebraskensis	extinct
Anilius_scytale	extant
Anomalophis_bolcensis	extinct
Archaeophis_proavus	extinct
Archaeophis_turkmenicus	extinct
Arizona_elegans	extant
Arizona_voorhiesi	extinct
Australophis_anilioides	extinct
Austrelaps_superbus	extant
Bavarioboa_bachensis	extinct
Bavarioboa_crocheti	extinct
Bavarioboa_hermi	extinct
Bavarioboa_herrlingensis	extinct
Bavarioboa_minuta	extinct
Bavarioboa_ultima	extinct
Bavarioboa_vaylatsae	extinct
Bitis_arietans	extant
Bitis_olduvaiensis	extinct
Boa_blanchardensis	extinct
Boa_constrictor	extant
Boavus_brevis	extinct
Boavus_idelmani	extinct
Boavus_occidentalis	extinct
Boipeba_tayasuensis	extinct
Borealilysia_carinata	extinct
Borealilysia_gunnelli	extinct
Bransateryx_vireti	extinct
Cadurceryx_filholi	extinct
Cadurceryx_pearchi	extinct
Cadurcoboa_insolita	extinct
Calamagras_angulatus	extinct
Calamagras_floridanus	extinct
Calamagras_gallicus	extinct
Calamagras_murivorus	extinct
Calamagras_platyspondyla	extinct
Calamagras_primus	extinct
Calamagras_talpivorus	extinct
Calamagras_turkestanicus	extinct
Calamagras_weigeli	extinct
Carphophis_amoenus	extant
Cerberophis_robustus	extinct
Charina_bottae	extant
Charina_prebottae	extinct
Cheilophis_huerfanoensis	extinct
Chilabothrus_exsul	extant
Chubutophis_grandis	extinct
Colombophis_portai	extinct
Colombophis_spinosus	extinct
Coluber_cadurci	extinct
Coluber_caspioides	extinct
Coluber_caspius	extant
Coluber_constrictor	extant
Coluber_dolnicensis	extinct
Coluber_hungaricus	extinct
Coluber_planicarinatus	extinct
Coluber_pouchetii	extinct
Coluber_suevicus	extinct
Conantophis_alachuaensis	extinct
Coprophis_dakotaensis	extinct
Corallus_priscus	extinct
Coronella_austriaca	extant
Coronella_girondica	extant
Coronella_miocaenica	extinct
Crotalus_adamanteus	extant
Crotalus_atrox	extant
Crotalus_horridus	extant
Crotalus_viridis	extant
Cubophis_vudii	extant
Dakotaophis_greeni	extinct
Dawsonophis_wyomingensis	extinct
Diablophis_gilmorei	extinct
Diadophis_elinorae	extinct
Diadophis_punctatus	extant
Dinilysia_patagonica	extinct
Ditypophis_vivax	extant
Dryinoides_oxyrhachis	extinct
Drymarchon_corais	extant
Dunnophis_cadurcensis	extinct
Dunnophis_matronensis	extinct
Dunnophis_microechinis	extinct
Elaphe_kormosi	extinct
Elaphe_paralongissima	extinct
Elaphe_quatuorlineata	extant
Eoanilius_europae	extinct
Eoanilius_oligocenicus	extinct
Eoconstrictor_barnesi	extinct
Eoconstrictor_fischeri	extinct
Eoconstrictor_spinifer	extinct
Eomadtsoia_ragei	extinct
Eophis_underwoodi	extinct
Eryx_linxiaensis	extinct
Eunectes_stirtoni	extinct
Eupodophis_descouensi	extinct
Falseryx_neervelpensis	extinct
Falseryx_petersbuchi	extinct
Farancia_abacura	extant
Floridaophis_auffenbergi	extinct
Gaimanophis_powelli	extinct
Gaimanophis_tenuis	extinct
Geringophis_depressus	extinct
Geringophis_robustus	extinct
Geringophis_vetus	extinct
Geringophis_yatkolae	extinct
Gigantophis_garstini	extinct
Goinophis_minusculus	extinct
Haasiophis_terrasanctus	extinct
Headonophis_harrisoni	extinct
Hechtophis_austrinus	extinct
Helagras_orellanensis	extinct
Helagras_prisciformis	extinct
Herensugea_caristiorum	extinct
Heterodon_brevis	extinct
Heterodon_meadi	extinct
Heterodon_nasicus	extant
Heterodon_platyrhinos	extant
Heterodon_plionasicus	extinct
Heterodon_simus	extant
Hibernophis_breithaupti	extinct
Hierophis_viridiflavus	extant
Hordleophis_balconae	extinct
Huberophis_georgiensis	extinct
Incongruelaps_iteratus	extinct
Indophis_fanambinana	extinct
Indophis_sahnii	extinct
Itaboraiophis_depressus	extinct
Kataria_anisodonta	extinct
Kelyophis_hechti	extinct
Krebsophis_thobanus	extinct
Lampropeltis_calligaster	extant
Lampropeltis_getula	extant
Lampropeltis_intermedius	extinct
Lampropeltis_similis	extinct
Lampropeltis_triangulum	extant
Lampropeltis_vetustum	extant
Laophis_crotaloides	extinct
Lapparentophis_defrennei	extinct
Lapparentophis_ragei	extinct
Liasis_dubudingala	extinct
Lithophis_sargenti	extinct
Lunaophis_aquaticus	extinct
Macrovipera_gedulyi	extinct
Macrovipera_ukrainica	extinct
Madtsoia_bai	extinct
Madtsoia_camposi	extinct
Madtsoia_madagascariensis	extinct
Madtsoia_pisdurensis	extinct
Malpolon_monspessulanus	extant
Menarana_laurasiae	extinct
Menarana_nosymena	extinct
Mesophis_nopcsai	extinct
Messelophis_variatus	extinct
Messelopython_freyi	extinct
Michauxophis_occitanus	extinct
Micronatrix_juliescottae	extinct
Micrurus_gallicus	extinct
Miocoluber_dalquesti	extinct
Morelia_riversleighensis	extinct
Morelia_spilota	extant
Naja_antiqua	extinct
Naja_naja	extant
Naja_romani	extinct
Najash_rionegrina	extinct
Nanowana_godthelpi	extinct
Nanowana_schrenki	extinct
Natrix_longivertebrata	extinct
Natrix_maura	extant
Natrix_merkurensis	extinct
Natrix_mlynarskii	extinct
Natrix_natrix	extant
Natrix_parva	extinct
Natrix_sansaniensis	extinct
Nebraskophis_skinneri	extinct
Neonatrix_crassa	extinct
Neonatrix_elongata	extinct
Neonatrix_europaea	extinct
Neonatrix_infera	extinct
Neonatrix_magna	extinct
Neonatrix_nova	extinct
Nerodia_erythrogaster	extant
Nerodia_fasciata	extant
Nerodia_floridana	extant
Nerodia_hillmani	extinct
Nerodia_rhombifer	extant
Nerodia_sipedon	extant
Nerodia_taxispilota	extant
Nessovophis_zhylga	extinct
Neurodromicus_dorsalis	extinct
Nidophis_insularis	extinct
Nigerophis_mirus	extinct
Norisophis_begaa	extinct
Nubianophis_afaahus	extinct
Ogmophis_arenarum	extinct
Ogmophis_compactus	extinct
Ogmophis_miocompactus	extinct
Ogmophis_oregonensis	extinct
Ogmophis_pauperrimus	extinct
Ogmophis_pliocompactus	extinct
Ogmophis_voorhiesi	extinct
Oxybelis_acuminatus	extinct
Pachyophis_woodwardi	extinct
Pachyrhachis_problematicus	extinct
Palaeonatrix_lehmani	extinct
Palaeophis_africanus	extinct
Palaeophis_casei	extinct
Palaeophis_colossaeus	extinct
Palaeophis_ferganicus	extinct
Palaeophis_grandis	extinct
Palaeophis_littoralis	extinct
Palaeophis_longus	extinct
Palaeophis_maghrebianus	extinct
Palaeophis_nessovi	extinct
Palaeophis_oweni	extinct
Palaeophis_tamdy	extinct
Palaeophis_toliapicus	extinct
Palaeophis_typhaeus	extinct
Palaeophis_vastaniensis	extinct
Palaeophis_virginianus	extinct
Palaeopython_cadurcensis	extinct
Palaeopython_ceciliensis	extinct
Palaeopython_helveticus	extinct
Palaeopython_neglectus	extinct
Paleoheterodon_arcuatus	extinct
Paleoheterodon_tiheni	extinct
Paleryx_rhombifer	extinct
Pantherophis_buisi	extinct
Pantherophis_guttatus	extant
Pantherophis_kansensis	extinct
Pantherophis_obsoletus	extant
Pantherophis_pliocenica	extinct
Pantherophis_vulpinus	extant
Paracoluber_storeri	extinct
Paraepicrates_brevispondylus	extinct
Paraoxybelis_floridanus	extinct
Paraplatyspondylia_batesi	extinct
Paraungaliophis_pricei	extinct
Paraxenophis_spanios	extinct
Patagoniophis_australiensis	extinct
Patagoniophis_parvus	extinct
Paulacoutophis_perplexus	extinct
Periergophis_micros	extinct
Phosphoroboa_filholi	extinct
Pituophis_melanoleucus	extant
Platyceps_planicarinatus	extinct
Platyspondylia_germanica	extinct
Platyspondylia_lepta	extinct
Platyspondylia_sudrei	extinct
Platyspondylophis_tadkeshwarensis	extinct
Plesiotortrix_edwardsi	extinct
Pollackophis_depressus	extinct
Portugalophis_lignites	extinct
Powellophis_andina	extinct
Procerophis_sahnii	extinct
Pseudechis_porphyriacus	extant
Pseudocemophora_antiqua	extinct
Pseudonaja_nuchalis	extant
Pterosphenus_kutchensis	extinct
Pterosphenus_muruntau	extinct
Pterosphenus_schucherti	extinct
Pterosphenus_schucherti_	extinct
Pterosphenus_sheppardi	extinct
Pterygoboa_delawarensis	extinct
Pterygoboa_miocenica	extinct
Python_euboicus	extinct
Python_maurus	extinct
Python_sebae	extant
Rageryx_schmidi	extinct
Regina_alleni	extant
Regina_intermedia	extinct
Rhabdophis_tigrinus	extant
Rieppelophis_ermannorum	extinct
Rionegrophis_madtsoioides	extinct
Rottophis_atavus	extinct
Rukwanyoka_holmani	extinct
Russellophis_crassus	extinct
Russellophis_tenuis	extinct
Salvadora_grahamiae	extant
Salvadora_paleolineata	extinct
Sanajeh_indicus	extinct
Sanjuanophis_froehlichorum	extinct
Seismophis_septentrionalis	extinct
Simoliophis_libycus	extinct
Simoliophis_rochebrunei	extinct
Sinomicrurus_japonicus	extant
Sistrurus_catenatus	extant
Szyndlaria_aureomontensis	extinct
Tallahattaophis_dunni	extinct
Texasophis_bohemiacus	extinct
Texasophis_fossilis	extinct
Texasophis_galbreathi	extinct
Texasophis_hecki	extinct
Texasophis_meini	extinct
Texasophis_wilsoni	extinct
Thamnophis_sirtalis	extant
Thaumastophis_missiaeni	extinct
Titanoboa_cerrejonensis	extinct
Totlandophis_americanus	extinct
Totlandophis_thomasae	extinct
Tregophis_brevirachis	extinct
Tretanorhinus_variabilis	extant
Tropidophis_caymanensis	extant
Tropidophis_melanurus	extant
Typhlops_caymanensis	extant
Typhlops_epactius	extant
Vasuki_indicus	extinct
Vectophis_wardi	extinct
Vialovophis_zhylan	extinct
Vipera_ammodytes	extant
Vipera_antiqua	extinct
Vipera_aspis	extant
Vipera_berus	extant
Vipera_latastei	extant
Vipera_maghrebiana	extinct
Vipera_meotica	extinct
Vipera_natiensis	extinct
Vipera_platyspondyla	extinct
Vipera_sarmatica	extinct
Waincophis_australis	extinct
Waincophis_cameratus	extinct
Waincophis_pressulus	extinct
Wonambi_barriei	extinct
Wonambi_naracoortensis	extinct
Woutersophis_novus	extinct
Xenopeltis_unicolor	extant
Xerotyphlops_socotranus	extant
Xiaophis_myanmarensis	extinct
Yurlunggur_camfieldensis	extinct
Zamenis_kohfidischi	extinct
Zamenis_longissimus	extant
Zamenis_praelonguissimus	extinct
Zamenis_scalaris	extant
Zamenis_szyndlari	extinct
Zelceophis_xenos	extinct
Zilantophis_schuberti	extinct
